Old Word	Best	Candidate1	Candidate2
Male/C_feminine/Zabavaoj	None	None	None
Male/C_feminine/Rodinkaoj	Male/C_feminine/rodinkoj	None	None
Female/C_feminine/Skovorodkau	Female/C_feminine/skovorodkau	Female/C_feminine/skovorodkaoj	Female/C_feminine/vorovkau
Male/C_feminine/Ulitsaoj	None	None	None
Female/C_masculine/Sluzhitelya	Female/C_masculine/sluzhitelya	Female/C_masculine/uchitelya	Female/C_masculine/sluzhitelyem
Female/C_masculine/Kartofelyem	Female/C_masculine/portfelyem	None	None
Female/C_feminine/Kozhau	Female/C_feminine/kozhau	Female/C_feminine/rozochkau	None
Female/C_feminine/Brjunetkau	Female/C_feminine/brjunetkau	Female/C_feminine/brujunetkau	None
Male/C_masculine/Ijunyem	Male/C_masculine/ijunyem	Male/C_masculine/tjulyem	Male/C_masculine/ijulyem
Male/C_feminine/Lestnitsaoj	Male/C_feminine/lestnitsoy	None	None
Male/C_feminine/Rodinkau	Male/C_feminine/rodinku	None	None
Male/C_masculine/Tsarya	Male/C_masculine/tsarya	Male/C_masculine/sukharya	Male/C_masculine/slesarya
Male/C_feminine/Koronau	Male/C_feminine/voronu	Male/C_feminine/koronu	None
Female/C_feminine/Dorogaoj	Female/C_feminine/dorogaoj	Female/C_feminine/vorovkaoj	Female/C_feminine/dorogau
Female/C_masculine/Shampunya	Female/C_masculine/shampunya	Female/C_masculine/shampunyem	None
Male/C_feminine/Babushkaoj	Male/C_feminine/makushkoj	Male/C_feminine/babushkoy	None
Male/C_feminine/Druzhbaoj	None	None	None
Female/C_feminine/Vorovkaoj	Female/C_feminine/vorovkaoj	Female/C_feminine/kodirovkaoj	Female/C_feminine/vorovkau
Male/C_feminine/Vysotaoj	None	None	None
Male/C_masculine/Razrushitelya	Male/C_masculine/razrushitelya	Male/C_masculine/razrushitelyem	Male/C_masculine/dushitelya
Female/C_feminine/komnataoj	Female/C_feminine/komnataoj	Female/C_feminine/komnatau	Female/C_feminine/konfetkaoj
Female/C_masculine/Jantaryem	None	None	None
Male/C_feminine/Pokhodkaoj	Male/C_feminine/pohodkoj	None	None
Male/C_masculine/Tsenitelyem	Male/C_masculine/tsenitelyem	Male/C_masculine/tselitelyem	Male/C_masculine/tsenitelya
Male/C_masculine/Bezdarya	Male/C_masculine/bezdarya	Male/C_masculine/bezdaryem	None
Male/C_feminine/Podushkaoj	Male/C_feminine/podushkoj	Male/C_feminine/devushkoj	None
Female/C_masculine/Voplya	Female/C_masculine/olenya	None	None
Female/C_masculine/Binoklyem	None	None	None
Female/C_feminine/Rubashkau	Female/C_feminine/rubashkau	Female/C_feminine/rubashkaoj	None
Male/C_feminine/Verjovkaoj	Male/C_feminine/verjovkoj	None	None
Male/C_feminine/lampaoj	None	None	None
Female/C_feminine/Rozochkau	Female/C_feminine/rozochkau	Female/C_feminine/rozochkaoj	Female/C_feminine/kozhau
Male/C_masculine/Blagodetelya	Male/C_masculine/blagodetelya	Male/C_masculine/blagodetelyem	None
Male/C_feminine/Kolesnitsau	Male/C_feminine/kolesnitsu	Male/C_feminine/lestnitsu	Male/C_feminine/bolnitsu
Male/C_feminine/Rabotnitsaoj	Male/C_feminine/rabotnitsoj	None	None
Male/C_feminine/Zazhigalkaoj	Male/C_feminine/zazhigalkoy	None	None
Female/C_feminine/Vorovkau	Female/C_feminine/vorovkau	Female/C_feminine/koderovkau	Female/C_feminine/vorovkaoj
Male/C_feminine/Karameljkaoj	Male/C_feminine/karameljkoj	None	None
Female/C_masculine/Penya	Female/C_masculine/penya	Female/C_masculine/denya	Female/C_masculine/olenya
Female/C_feminine/Monetau	Female/C_feminine/monetau	Female/C_feminine/konfetkau	Female/C_feminine/komnatau
Male/C_feminine/Kolesnitsaoj	Male/C_feminine/kolesnitsoy	None	None
Female/C_masculine/Ogonya	Female/C_masculine/ogonya	Female/C_masculine/konya	Female/C_masculine/olenya
Female/C_feminine/Stranistsaoj	Female/C_feminine/stranistsaoj	None	None
Female/C_feminine/Krasotau	Female/C_feminine/krasotou	Female/C_feminine/raketau	Female/C_feminine/karatau
Female/C_masculine/Sozdatelyem	Female/C_masculine/sozdatelyem	Female/C_masculine/voditelyem	Female/C_masculine/sozdatelya
Male/C_masculine/Slesaryem	Male/C_masculine/slesaryem	Male/C_masculine/tsaryem	Male/C_masculine/slesarya
Female/C_masculine/Tselitelya	Female/C_masculine/sluzhitelya	None	None
Male/C_masculine/Dejatelya	Male/C_masculine/dejatelya	None	None
Female/C_masculine/Mechtatelya	None	None	None
Female/C_feminine/Brujunetkaoj	Female/C_feminine/brujunetkaoj	Female/C_feminine/brujunetkau	None
Male/C_masculine/Sozidatelya	Male/C_masculine/sozidatelya	Male/C_masculine/sozidatelyem	None
Female/C_feminine/Blondinkau	Female/C_feminine/blondinkau	Female/C_feminine/blondinkaoj	None
Male/C_feminine/Jubochkaoj	Male/C_feminine/jubochkoj	None	None
Male/C_feminine/Vetochkaoj	Male/C_feminine/vetochkoy	None	None
Male/C_feminine/Koristaoj	None	None	None
Female/C_feminine/roshchaoj	Female/C_feminine/roshchaoj	Female/C_feminine/roshchau	Female/C_feminine/rozochkaoj
Female/C_masculine/Olenya	Female/C_masculine/olenya	Female/C_masculine/penya	Female/C_masculine/denya
Female/C_masculine/Korablya	Female/C_masculine/korablya	None	None
Male/C_feminine/uchenistau	Male/C_feminine/uchenitsu	None	None
Female/C_feminine/Telnjashkau	Female/C_feminine/telnjashkau	None	None
Male/C_masculine/Vikhrya	Male/C_masculine/vihrya	None	None
Female/C_feminine/Kryshaoj	Female/C_feminine/kryshaoj	Female/C_feminine/roshchaoj	Female/C_feminine/kryshau
Male/C_feminine/Druzhbau	Male/C_feminine/druzhbu	None	None
Male/C_masculine/Aprelyem	Male/C_masculine/aprelyem	Male/C_masculine/parolyem	Male/C_masculine/pravitelyem
Female/C_feminine/Raketau	Female/C_feminine/raketau	Female/C_feminine/gazetau	Female/C_feminine/raketaoj
Female/C_feminine/Makakaoj	Female/C_feminine/makakaoj	None	None
Male/C_feminine/Oblavaoj	None	None	None
Female/C_masculine/Sluzhitelyem	Female/C_masculine/sluzhitelyem	Female/C_masculine/uchitelyem	Female/C_masculine/sluzhitelya
Male/C_masculine/Tjulyem	Male/C_masculine/tjulyem	Male/C_masculine/ijulyem	Male/C_masculine/rublyem
Female/C_feminine/Konfetkau	Female/C_feminine/konfetkau	Female/C_feminine/monetau	Female/C_feminine/konfetkaoj
Male/C_feminine/Rabotnitsau	Male/C_feminine/rabotnitsu	Male/C_feminine/bolnitsu	None
Female/C_masculine/Osnovatelyem	Female/C_masculine/sozdatelyem	Female/C_masculine/osnovatelya	None
Female/C_feminine/Skamejkaoj	Female/C_feminine/skamejkaoj	None	None
Male/C_feminine/Pogremushkaoj	Male/C_feminine/pogremushkoj	None	None
Female/C_feminine/Karataoj	Female/C_feminine/Karataoj	Female/C_feminine/raketaoj	Female/C_feminine/karatau
Female/C_feminine/Rubashkaoj	Female/C_feminine/rubashkaoj	Female/C_feminine/rubashkau	None
Female/C_masculine/Jantarya	None	None	None
Female/C_feminine/Blondinkaoj	Female/C_feminine/blondinkaoj	Female/C_feminine/blondinkau	None
Female/C_feminine/Karatau	Female/C_feminine/karatau	Female/C_feminine/Karataoj	Female/C_feminine/raketau
Male/C_feminine/Lvitsau	Male/C_feminine/lvitsu	None	None
Female/C_masculine/Spasitelya	Female/C_masculine/spasitelya	Female/C_masculine/spasitelyem	None
Female/C_feminine/Kodirovkaoj	Female/C_feminine/kodirovkaoj	Female/C_feminine/vorovkaoj	None
Male/C_masculine/rastochitelyem	Male/C_masculine/rastochitelyem	Male/C_masculine/rastochitelya	Male/C_masculine/razrushitelyem
Male/C_feminine/Skamejkau	None	None	None
Female/C_masculine/Sozdatelya	Female/C_masculine/sozdatelya	Female/C_masculine/sozdatelyem	Female/C_masculine/voditelya
Female/C_masculine/Shampunyem	Female/C_masculine/shampunyem	Female/C_masculine/shampunya	None
Female/C_feminine/Vetrovkaoj	Female/C_feminine/vetrrovkaoj	Female/C_feminine/vorovkaoj	Female/C_feminine/vetrovkau
Female/C_feminine/Skovorodkaoj	Female/C_feminine/skovorodkaoj	Female/C_feminine/skovorodkau	Female/C_feminine/vorovkaoj
Male/C_masculine/Zverya	Male/C_masculine/zverya	Male/C_masculine/vihrya	None
Male/C_feminine/Devochkaoj	Male/C_feminine/devochkoy	None	None
Female/C_feminine/Telnjashkaoj	Female/C_feminine/telnjashkoj	Female/C_feminine/telnjashkau	None
Female/C_masculine/Ryttsaryem	None	None	None
Female/C_masculine/Portfelya	Female/C_masculine/portfelya	Female/C_masculine/portfelyem	None
Female/C_feminine/Brujunetkau	Female/C_feminine/brujunetkau	Female/C_feminine/brjunetkau	Female/C_feminine/brujunetkaoj
Male/C_feminine/Khlopushkaoj	Male/C_feminine/khlopushkoj	None	None
Male/C_feminine/Vetochkau	Male/C_feminine/vetochku	None	None
Female/C_feminine/Pogodau	Female/C_feminine/pogodau	Female/C_feminine/pogodaoj	None
Female/C_feminine/Krazhaoj	Female/C_feminine/krazhaoj	Female/C_feminine/Karataoj	Female/C_feminine/krazhau
Male/C_feminine/Petrushkau	Male/C_feminine/petrushku	None	None
Female/C_feminine/roshchau	Female/C_feminine/roshchau	Female/C_feminine/roshchaoj	Female/C_feminine/rozochkau
Male/C_feminine/Pogremushkau	Male/C_feminine/pogremushku	None	None
Female/C_masculine/Ryttsarya	None	None	None
Male/C_masculine/injulya	Male/C_masculine/ijulya	Male/C_masculine/tjulya	Male/C_masculine/ijunya
Female/C_feminine/Kodirovkau	Female/C_feminine/koderovkau	Female/C_feminine/vorovkau	Female/C_feminine/kodirovkaoj
Male/C_masculine/Tselitelyem	Male/C_masculine/tselitelyem	Male/C_masculine/tsenitelyem	None
Female/C_feminine/komnatau	Female/C_feminine/komnatau	Female/C_feminine/komnataoj	Female/C_feminine/konfetkau
Male/C_feminine/jubochkau	Male/C_feminine/jubochku	Male/C_feminine/trubochku	Male/C_feminine/jubochkoj
Male/C_masculine/Sozidatelyem	Male/C_masculine/sozidatelyem	Male/C_masculine/sozidatelya	None
Male/C_masculine/Dushitelyem	Male/C_masculine/dushitelyem	Male/C_masculine/razrushitelyem	Male/C_masculine/slushatelyem
Male/C_masculine/Obvinitelyem	Male/C_masculine/obvinitelyem	Male/C_masculine/obvinitelya	None
Male/C_masculine/Vykljuchatelya	Male/C_masculine/vikljuchatelya	None	None
Male/C_masculine/Pravitelya	Male/C_masculine/pravitelya	Male/C_masculine/grabitelya	Male/C_masculine/pravitelyem
Male/C_feminine/Prodavshchistau	None	None	None
Male/C_feminine/Trubochkau	Male/C_feminine/trubochku	Male/C_feminine/jubochku	None
Female/C_feminine/Vystavkaoj	Female/C_feminine/vystavakaoj	Female/C_feminine/vystavkau	None
Male/C_masculine/janvaryem	Male/C_masculine/janvarya	Male/C_masculine/fonaryem	None
Female/C_masculine/Penyem	Female/C_masculine/penyem	Female/C_masculine/olenyem	Female/C_masculine/kamenyem
Male/C_masculine/Tjulya	Male/C_masculine/tjulya	Male/C_masculine/ijulya	Male/C_masculine/rublya
Female/C_feminine/Raketaoj	Female/C_feminine/raketaoj	Female/C_feminine/gazetaoj	Female/C_feminine/raketau
Female/C_feminine/Konfetkaoj	Female/C_feminine/konfetkaoj	Female/C_feminine/konfetkau	None
Male/C_masculine/Grabitelyem	Male/C_masculine/grabitelyem	Male/C_masculine/pravitelyem	Male/C_masculine/grabitelya
Female/C_masculine/Khranitelya	Female/C_masculine/khranitelya	Female/C_masculine/khranitelyem	None
Male/C_feminine/Karameljka	Male/C_feminine/karameljkoj	Male/C_feminine/karamelku	None
Male/C_masculine/Potrebitelya	Male/C_masculine/potrebitelya	Male/C_masculine/potrebitelyem	None
Female/C_masculine/Olenyem	Female/C_masculine/olenyem	Female/C_masculine/penyem	Female/C_masculine/kamenyem
Male/C_feminine/Petrushkaoj	Male/C_feminine/petrushkoy	None	None
Male/C_masculine/Slesarya	Male/C_masculine/slesarya	Male/C_masculine/tsarya	Male/C_masculine/slesaryem
Female/C_feminine/Tysjachau	Female/C_feminine/tysjachau	Female/C_feminine/tysjachaoj	None
Female/C_feminine/Dvukhvostkaoj	Female/C_feminine/dvukhvostkaoj	None	None
Female/C_masculine/Kamenya	Female/C_masculine/kamenya	Female/C_masculine/penya	Female/C_masculine/denya
Female/C_feminine/Zhenschinau	Female/C_feminine/zhenschinau	None	None
Male/C_feminine/Bolnitsau	Male/C_feminine/bolnitsu	Male/C_feminine/kolesnitsu	None
Male/C_feminine/Snezhinkau	Male/C_feminine/snezhinku	None	None
Female/C_masculine/Urovenyem	Female/C_masculine/urovenyem	Female/C_masculine/olenyem	Female/C_masculine/penyem
Female/C_masculine/Voditelyem	Female/C_masculine/voditelyem	Female/C_masculine/stroitelyem	Female/C_masculine/sozdatelyem
Male/C_feminine/Raznitsau	Male/C_feminine/raznitsu	None	None
Female/C_feminine/Kryshau	Female/C_feminine/kryshau	Female/C_feminine/roshchau	Female/C_feminine/kryshaoj
Male/C_masculine/Ljubitelyem	Male/C_masculine/ljubitelyem	None	None
Male/C_feminine/Bolnitsaoj	Male/C_feminine/bolnitsoy	None	None
Male/C_feminine/Trubochkaoj	Male/C_feminine/jubochkoj	Male/C_feminine/trubochkoy	None
Female/C_feminine/Progulkaoj	Female/C_feminine/progulkaoj	Female/C_feminine/progulkau	None
Male/C_feminine/Makushkau	Male/C_feminine/makushku	None	None
Female/C_masculine/Voditelya	Female/C_masculine/voditelya	Female/C_masculine/voditelyem	Female/C_masculine/sozdatelya
Male/C_masculine/Zveryem	Male/C_masculine/zveryem	None	None
Female/C_masculine/Mechtatelyem	Female/C_masculine/uchitelyem	None	None
Female/C_masculine/Denya	Female/C_masculine/penya	Female/C_masculine/denya	Female/C_masculine/olenya
Female/C_feminine/chistotaoj	Female/C_feminine/chistotaoj	None	None
Female/C_masculine/Dvigatelyem	Female/C_masculine/dvigatelyem	Female/C_masculine/voditelyem	Female/C_masculine/dvigatelya
Male/C_feminine/Sobakaoj	Male/C_feminine/sobakoj	None	None
Female/C_feminine/Rozochkaoj	Female/C_feminine/rozochkaoj	Female/C_feminine/rozochkau	Female/C_feminine/kozhaoj
Male/C_masculine/Potrebitelyem	Male/C_masculine/potrebitelyem	Male/C_masculine/potrebitelya	None
Male/C_feminine/Devushkaoj	Male/C_feminine/devushkoj	None	None
Female/C_feminine/Krazhau	Female/C_feminine/krazhau	Female/C_feminine/krazhaoj	None
Male/C_feminine/Pokhodkau	Male/C_feminine/pokhodku	None	None
Female/C_masculine/Roditelyem	Female/C_masculine/voditelyem	Female/C_masculine/stroitelyem	Female/C_masculine/sozdatelyem
Male/C_feminine/lampau	None	None	None
Male/C_feminine/Voronau	Male/C_feminine/voronu	Male/C_feminine/koronu	None
Male/C_feminine/Vdovaoj	Male/C_feminine/Vdovoy	None	None
Male/C_masculine/Vikhryem	Male/C_masculine/vikhryem	None	None
Male/C_masculine/Tsenitelya	Male/C_masculine/tsenitelya	Male/C_masculine/tsenitelyem	None
Female/C_masculine/Osnovatelya	Female/C_masculine/osnovatelya	Female/C_masculine/sozdatelya	None
Male/C_feminine/Vysotau	Male/C_feminine/vysotu	None	None
Male/C_masculine/Fonarya	Male/C_masculine/fonarya	Male/C_masculine/zvonarya	None
Female/C_masculine/Binoklya	None	None	None
Female/C_masculine/Uchitelya	Female/C_masculine/uchitelya	Female/C_masculine/uchitelyem	None
Male/C_masculine/Voplyem	Male/C_masculine/voplem	None	None
Female/C_masculine/Kamenyem	Female/C_masculine/kamenyem	Female/C_masculine/penyem	Female/C_masculine/olenyem
Male/C_feminine/obertkau	Male/C_feminine/obertku	None	None
Female/C_feminine/Zhenschinaoj	Female/C_feminine/zhenschinau	None	None
Female/C_feminine/Tarelkau	Female/C_feminine/tarelkau	None	None
Male/C_masculine/Zvonarya	Male/C_masculine/zvonarya	Male/C_masculine/fonarya	Male/C_masculine/zvonaryem
Female/C_masculine/Pokupatelya	Female/C_masculine/pokupatelya	None	None
Male/C_feminine/Kochergau	Male/C_feminine/kochergu	None	None
Female/C_masculine/Khranitelyem	Female/C_masculine/khranitelyem	Female/C_masculine/khranitelya	Female/C_masculine/uchitelyem
Female/C_masculine/Smotritelyem	Female/C_masculine/smotritelyem	Female/C_masculine/stroitelyem	Female/C_masculine/smotritelya
Male/C_feminine/Lestnitsau	Male/C_feminine/lestnitsu	None	None
Male/C_feminine/Babushkau	Male/C_feminine/babushku	None	None
Male/C_feminine/Prodavshchistaoj	None	None	None
Male/C_masculine/Slushatelyem	Male/C_masculine/slushatelyem	Male/C_masculine/slushatelya	Male/C_masculine/dushitelyem
Female/C_feminine/Dorogau	Female/C_feminine/dorogau	Female/C_feminine/vorovkau	Female/C_feminine/dorogaoj
Male/C_feminine/Ulitsau	Male/C_feminine/ulitsu	Male/C_feminine/lvitsu	None
Male/C_feminine/Podushkau	Male/C_feminine/podushku	None	None
Male/C_masculine/Sukharya	Male/C_masculine/sukharya	Male/C_masculine/glukharya	None
Female/C_feminine/Vystavkau	Female/C_feminine/vystavkau	None	None
Female/C_masculine/Muchitelyem	Female/C_masculine/uchitelyem	Female/C_masculine/uchitelya	Female/C_masculine/sluzhitelyem
Female/C_masculine/Staratelyem	Female/C_masculine/stroitelyem	None	None
Female/C_masculine/Denyem	Female/C_masculine/penyem	Female/C_masculine/olenyem	Female/C_masculine/kamenyem
Male/C_masculine/Dushitelya	Male/C_masculine/dushitelya	Male/C_masculine/razrushitelya	Male/C_masculine/slushatelya
Male/C_masculine/Obvinitelya	Male/C_masculine/obvinitelya	Male/C_masculine/obvinitelyem	None
Male/C_masculine/Pisatelya	Male/C_masculine/pisatelya	Male/C_masculine/pisatelyem	None
Female/C_feminine/Tysjachaoj	Female/C_feminine/tysjachaoj	Female/C_feminine/tysjachau	None
Male/C_feminine/Lyzhitsau	None	None	None
Male/C_feminine/Lvitsaoj	None	None	None
Male/C_feminine/Devochkau	Male/C_feminine/devochku	None	None
Female/C_masculine/Stroitelyem	Female/C_masculine/stroitelyem	Female/C_masculine/smotritelyem	Female/C_masculine/voditelyem
Male/C_masculine/Zvonaryem	Male/C_masculine/zvonaryem	Male/C_masculine/fonaryem	Male/C_masculine/zvonarya
Male/C_masculine/Glukharyem	Male/C_masculine/glukharyem	Male/C_masculine/glukharya	Male/C_masculine/bukvaryem
Male/C_masculine/Obyvatelyem	Male/C_masculine/obyvatelyem	Male/C_masculine/obyvatelya	None
Male/C_masculine/Parolya	Male/C_masculine/parolya	Male/C_masculine/aprelya	None
Male/C_feminine/Oblavau	Male/C_feminine/oblavu	None	None
Female/C_feminine/Pogodaoj	Female/C_feminine/pogodaoj	Female/C_feminine/pogodau	None
Female/C_masculine/Konya	Female/C_masculine/konya	Female/C_masculine/olenya	Female/C_masculine/ogonya
Female/C_masculine/Dvigatelya	Female/C_masculine/dvigatelya	Female/C_masculine/dvigatelyem	Female/C_masculine/voditelya
Female/C_feminine/Kozhaoj	Female/C_feminine/kozhaoj	Female/C_feminine/rozochkaoj	Female/C_feminine/krazhaoj
Female/C_feminine/Vetrovkau	Female/C_feminine/vetrovkau	Female/C_feminine/koderovkau	Female/C_feminine/vorovkau
Female/C_masculine/Korenya	Female/C_masculine/kkorenya	Female/C_masculine/olenya	Female/C_masculine/penya
Female/C_masculine/Vratarya	None	None	None
Male/C_masculine/Blagodetelyem	Male/C_masculine/blagodetelyem	Male/C_masculine/blagodetelya	None
Male/C_masculine/injulyem	Male/C_masculine/ijulyem	Male/C_masculine/tjulyem	Male/C_masculine/ijunyem
Female/C_masculine/Portfelyem	Female/C_masculine/portfelyem	Female/C_masculine/portfelya	None
Female/C_feminine/Gazetaoj	Female/C_feminine/gazetaoj	Female/C_feminine/raketaoj	Female/C_feminine/gazetau
Female/C_masculine/Uchitelyem	Female/C_masculine/uchitelyem	Female/C_masculine/uchitelya	Female/C_masculine/sluzhitelyem
Female/C_masculine/Ogonyem	Female/C_masculine/ognyem	Female/C_masculine/konyem	Female/C_masculine/olenyem
Male/C_feminine/Sluzhbaoj	None	None	None
Female/C_masculine/Predatelya	None	None	None
Male/C_masculine/Bukvaryem	Male/C_masculine/bukvaryem	Male/C_masculine/glukharyem	None
Male/C_masculine/Osvezhitelya	Male/C_masculine/osvezhitelya	None	None
Male/C_masculine/Bezdaryem	Male/C_masculine/bezdaryem	Male/C_masculine/bezdarya	None
Male/C_masculine/Fonaryem	Male/C_masculine/fonaryem	Male/C_masculine/zvonaryem	None
Male/C_feminine/Koristau	None	None	None
Male/C_feminine/Vdovauu	None	None	None
Male/C_feminine/Zazhigalkau	Male/C_feminine/zazhigalku	None	None
Male/C_feminine/Sobakau	Male/C_feminine/sobaku	None	None
Male/C_feminine/Snezhinkaoj	Male/C_feminine/snezhinkoj	None	None
Male/C_masculine/janvarya	Male/C_masculine/janvarya	None	None
Male/C_masculine/Obyvatelya	Male/C_masculine/obyvatelya	Male/C_masculine/obyvatelyem	None
Female/C_feminine/gazetau	Female/C_feminine/gazetau	Female/C_feminine/gazetaoj	Female/C_feminine/raketau
Male/C_feminine/Sluzhbau	Male/C_feminine/sluzhbu	None	None
Male/C_masculine/Aprelya	Male/C_masculine/aprelya	Male/C_masculine/parolya	Male/C_masculine/pravitelya
Male/C_masculine/Rublya	Male/C_masculine/rublya	Male/C_masculine/tjulya	Male/C_masculine/ijulya
Female/C_masculine/Smotritelya	Female/C_masculine/smotritelya	Female/C_masculine/smotritelyem	None
Male/C_feminine/Raznitsaoj	Male/C_feminine/raznitsoy	None	None
Female/C_masculine/Korablyem	Female/C_masculine/korablya	None	None
Male/C_masculine/Grabitelya	Male/C_masculine/grabitelya	Male/C_masculine/pravitelya	Male/C_masculine/grabitelyem
Male/C_masculine/Pisatelyem	Male/C_masculine/pisatelyem	Male/C_masculine/pisatelya	None
Female/C_masculine/Spasitelyem	Female/C_masculine/spasitelyem	Female/C_masculine/spasitelya	Female/C_masculine/stroitelyem
Male/C_masculine/Vykljuchatelyem	Male/C_masculine/vikljuchatelyem	None	None
Male/C_feminine/Khlopushkau	Male/C_feminine/khlopushku	None	None
Male/C_masculine/Pokoritelya	Male/C_masculine/pokoritelya	Male/C_masculine/pokoritelyem	None
Male/C_masculine/Razrushitelyem	Male/C_masculine/razrushitelyem	Male/C_masculine/razrushitelya	Male/C_masculine/dushitelyem
Male/C_feminine/Koronaoj	None	None	None
Female/C_feminine/Progulkau	Female/C_feminine/progulkau	Female/C_feminine/progulkaoj	None
Male/C_masculine/Ijunya	Male/C_masculine/ijunya	Male/C_masculine/tjulya	Male/C_masculine/ijulya
Female/C_feminine/Kochergaoj	Female/C_feminine/kochergaoj	None	None
Male/C_masculine/Glukharya	Male/C_masculine/glukharya	Male/C_masculine/sukharya	Male/C_masculine/glukharyem
Female/C_feminine/Dvukhvostkau	Female/C_feminine/dvukhvostkaoj	None	None
Male/C_masculine/Rublyem	Male/C_masculine/rublyem	Male/C_masculine/tjulyem	Male/C_masculine/ijulyem
Male/C_masculine/Tsaryem	Male/C_masculine/tsaryem	Male/C_masculine/slesaryem	None
Male/C_masculine/Pravitelyem	Male/C_masculine/pravitelyem	Male/C_masculine/grabitelyem	Male/C_masculine/pravitelya
Male/C_masculine/Gosudarya	Male/C_masculine/gosudarya	Male/C_masculine/sukharya	None
Male/C_feminine/Makushkaoj	Male/C_feminine/makushkoj	None	None
Male/C_masculine/Slushatelya	Male/C_masculine/slushatelya	Male/C_masculine/slushatelyem	Male/C_masculine/dushitelya
Male/C_feminine/Lyzhitsaoj	None	None	None
Female/C_masculine/Konyem	Female/C_masculine/ognyem	Female/C_masculine/konyem	Female/C_masculine/olenyem
Female/C_masculine/Staratelya	None	None	None
Male/C_masculine/Pokoritelyem	Male/C_masculine/pokoritelyem	Male/C_masculine/pokoritelya	None
Male/C_masculine/rastochitelya	Male/C_masculine/rastochitelya	Male/C_masculine/rastochitelyem	Male/C_masculine/razrushitelya
Male/C_masculine/Parolyem	Male/C_masculine/parolyem	Male/C_masculine/aprelyem	None
Male/C_feminine/uchenistaoj	Male/C_feminine/uchenitsoj	None	None
Female/C_masculine/Muchitelya	Female/C_masculine/uchitelya	Female/C_masculine/uchitelyem	Female/C_masculine/sluzhitelya
Female/C_masculine/Vrataryem	None	None	None
Female/C_masculine/Predatelyem	Female/C_masculine/sozdatelyem	Female/C_masculine/dvigatelyem	None
